1111111111111111111111111111111111
1E0000011111000C00000C0000C0000001
1010010100100000101001000000010101
1011111111101010001001000000010101
1P0000000C00C00000C0000000000000C1
1111111111111111111111111111111111
