11111
1CCC1
111E1
1PC01
11111
