11111111111111111111111
1P0000011111000C00000C1
10100100000000001010011
10111111111010100010011
100000000C00C00001C0001
1000C000000000000100001
10011000011111111100001
100000000100C0100000001
1C00000001E110101110001
10001111111100101000001
100010000000C0001000001
1C0010C0011111111000001
10001111110000000000001
1C00000000000000000C001
11111111111111111111111
