111111
1E0001
1C00P1
111111
110101
111111
