111111111111111111111111111111111111111111
1000000000000000000000000000000 0000000001
110 00000000000000000000000000000000000001
111 1111 000000000000000000000000000000 11
101000000000000000000000000000000000000001
10000000000000000000000000000000000000001
10000000000000000000000000000000000000001
1000000000000000000000000000000000000001
10000000000000000000000000000000000001
10000000000000000000000000000000001
100000000000000000000000000000000000000001
111111111111111111111111111111111111111111
