111101
100001
1C00E1
100001
1P0001
111111
