111101
100001
0C00E1
100001
1P0001
111111
