111101
100001
1C00E1
100000
1P0001
111111
